A=100
C=
B=400

.............
.............
..A.....B....
.....C.......
.............
......$......
